00000000
00000000
00000000
00000000
00000000
00000000
00000000
00000000
00000000
3DC3910D
0BC80005
3F278DDF
0B100005
3F800000
0C440004
3F278DDF
0DA20000
3DC3910D
3DC3910D
